................................
................................
................................
..%%%%%..%%%..%...%.%..%..%%%...
....%...%...%.%%..%.%.%..%......
....%...%...%.%.%.%.%%....%%....
....%...%%%%%.%..%%.%.%.....%...
....%...%...%.%...%.%..%.%%%....
....#...#...#.#...#.#..#.###....
................................
...*..................**........
..***.....................***...
..**..***................****...
.......***.................*....
................................
................................
................................
................................
.......***.................*....
..**..***................****...
..***.....................***...
...*..................**........
................................
....#...#...#.#...#.#..#.###....
....%...%...%.%...%.%..%.%%%....
....%...%%%%%.%..%%.%.%.....%...
....%...%...%.%.%.%.%%....%%....
....%...%...%.%%..%.%.%..%......
..%%%%%..%%%..%...%.%..%..%%%...
................................
................................
................................
300